11111111
1000PCC1
1C1CCCC1
101CCCC1
1E1CCCC1
11111111