11111111111111111111111111
1C1000C000C0C00C00C00001E1
1011110100C001011110010001
10100101010100C00010010101
100C00C00C01111100C001C0C1
1C101001000C01010010010101
111010010111000100100101C1
1C100C000C00C0C00000C000C1
10100111000011010010010101
1C000C000C1011C11010010101
100111100C10C00010C00C00C1
10C00C000C10000C1010000101
11111100111110111110010101
11111100111110111110010101
1P000C000C001C0C1C00C001C1
11111111111111111111111111